[
    { 
        size: [13, 10],
        map:[
            1,1,1,1,1,1,1,1,1,1,1,1,1,
            1,8,0,0,0,0,0,0,0,0,0,0,1,
            1,0,17,0,0,0,1,0,0,0,0,0,1,
            1,0,30,0,0,0,0,0,0,0,0,0,1,
            1,0,0,0,0,0,1,0,0,0,0,0,1,
            1,0,0,0,1,0,0,0,0,0,1,0,1,
            1,0,0,0,0,0,0,0,0,0,0,0,1,
            1,0,0,0,0,1,0,0,0,0,0,0,1,
            1,0,0,0,0,0,0,0,0,0,0,0,1,
            1,1,1,1,1,1,1,1,1,1,1,1,1
        ]
    }, {
        size: [9, 9],
        map:[
            1,1,1,1,1,1,1,1,1,
            1,0,0,0,1,0,0,0,1,
            1,0,30,17,0,17,30,0,1,
            1,0,17,30,17,30,17,0,1,
            1,1,0,17,8,17,0,1,1,
            1,0,17,30,17,30,17,0,1,
            1,0,30,17,0,17,30,0,1,
            1,0,0,0,1,0,0,0,1,
            1,1,1,1,1,1,1,1,1
        ]
    },{
        size: [8, 9],
        map:[
            1,1,1,1,1,1,0,0,
            1,30,1,0,0,1,1,0,
            1,30,30,30,0,0,1,1,
            1,0,1,17,0,0,0,1,
            1,0,17,8,1,0,0,1,
            1,1,0,17,0,17,0,1,
            0,1,17,0,17,0,1,1,
            0,1,0,0,0,1,1,0,
            0,1,1,1,1,1,0,0
        ]
    },{
        size: [11, 12],
        map:[
            1,1,1,1,1,1,1,1,0,0,0,
            1,0,0,1,0,0,0,1,0,0,0,
            1,0,0,0,17,0,0,1,0,0,0,
            1,0,0,1,1,0,1,1,1,1,1,
            1,0,17,1,30,0,1,1,0,0,1,
            1,1,0,1,30,0,0,0,17,0,1,
            0,1,0,1,30,0,1,1,0,0,1,
            0,1,0,1,30,1,1,1,0,1,1,
            0,1,8,0,0,0,1,1,0,0,1,
            0,1,1,0,17,0,0,0,0,0,1,
            0,0,1,1,1,1,1,1,0,0,1,
            0,0,0,0,0,0,0,1,1,1,1
        ]
    },{
        size: [7, 8],
        map:[
            0,0,1,1,1,1,0,
            0,0,1,0,0,1,0,
            1,1,1,17,0,1,1,
            1,0,17,0,0,8,1,
            1,0,30,30,30,0,1,
            1,1,17,0,0,1,1,
            0,1,0,0,1,1,0,
            0,1,1,1,1,0,0
        ]
    },{
        size: [13, 12],
        map:[
            0,1,1,1,1,1,1,1,1,1,1,1,0,
            0,1,0,0,0,0,0,0,0,0,0,1,0,
            0,1,0,17,0,0,1,1,1,1,17,1,1,
            0,1,1,8,0,0,17,0,0,0,0,0,1,
            0,1,0,0,1,30,17,30,1,0,17,0,1,
            1,1,17,17,1,30,17,0,1,0,1,1,1,
            1,0,0,0,0,1,30,30,0,0,1,0,0,
            1,0,17,17,0,1,30,1,1,17,1,0,0,
            1,1,1,0,0,1,30,1,1,0,1,0,0,
            0,0,1,0,0,0,30,0,0,0,1,0,0,
            0,0,1,1,1,1,0,0,1,1,1,0,0,
            0,0,0,0,0,1,1,1,1,0,0,0,0
        ]
    }
];
